11111111111111111111111111111
10P00000000000001000010000101
10000000000000001000010000101
10000000000000001000010000101
10000000000001000010000101
10000000000000001000010000101
1000E000000000001000010000101
100000000C0000001000010000101
10000000000000100001000010001
11111111111111111111111111111
