1111111111111111111111111
1000000000000000000000001
1000000000000000000000001
1000P00000000000000000001
1000000000000000000000001
1000000000000000000000001
1000000000000000000000001
1000000000000000000000001
1000000000000000E00000001
1000000000000000000000001
1000000000000000000000001
1111111111111111111111111
