1111111111111111111111111
1000000000000000000000001
1000000000000000000000001
1000000000C00000000000001
1000000000000000000000001
100000000001000E000000001
100000000000000C000000001
100000000000000P000000001
1000000000000000000000001
1000000000000000000000001
1111111111111111111111111
