111111111111
100000000001
100000000001
100000000001
100000000001
100000000001
100P00000001
100000000001
100000000001
100000000001
100000000001
100000000001
100000000001
100000000001
100000000001
100000000001
100000000001
100000000001
100000000001
100111000001
1001E1000001
111111111111



