1111111111111111111111111
1000000000000000000000001
1000010000000000000000001
10001E1000000000000000001
1000000000100000000000001
1000000001C10000000000001
1000000000000000000000001
1000000000000000000000001
100C000000000000000000001
1000000000000000000000001
10000000000000000000000P1
1111111111111111111111111
