1111111111111111111111111
1000E00000000000000000001
1000C00000000000000000001
1000000000000000000000001
1000000000000000000000001
1000000000000000000000001
1000000000000000000000001
1000000000000000000000001
1000P00000000000000000001
1000000000000000000000001
1000000000000000000000001
1111111111111111111111111
